{
  "MapCeiling": [
    [ 2, 2, 2, 2, 2, 2, 2, 2, 2, 2, 2, 2 ],
    [ 2, 2, 2, 2, 2, 2, 2, 2, 2, 2, 2, 2 ],
    [ 2, 3, 2, 3, 2, 2, 2, 2, 2, 2, 2, 2 ],
    [ 2, 1, 2, 2, 2, 2, 2, 2, 2, 2, 2, 2 ],
    [ 2, 3, 2, 2, 2, 2, 2, 2, 2, 2, 2, 2 ],
    [ 2, 2, 2, 2, 2, 2, 2, 2, 2, 2, 2, 2 ],
    [ 2, 2, 2, 2, 2, 2, 3, 2, 2, 2, 2, 2 ],
    [ 2, 2, 2, 2, 2, 2, 2, 2, 2, 2, 2, 2 ],
    [ 2, 2, 2, 2, 2, 2, 2, 2, 2, 2, 2, 2 ],
    [ 2, 2, 2, 2, 2, 2, 2, 2, 2, 2, 2, 2 ],
    [ 2, 2, 2, 2, 2, 2, 2, 2, 2, 2, 2, 2 ],
    [ 2, 2, 2, 2, 2, 2, 2, 2, 2, 2, 2, 2 ]
  ],
  "MapWalls": [
    [ 1, 1, 4, 1, 1, 1, 1, 1, 1, 1, 1, 1 ],
    [ 1, 0, 0, 0, 0, 1, 0, 0, 0, 0, 0, 1 ],
    [ 1, 0, 0, 2, 0, 2, 2, 0, 2, 2, 0, 1 ],
    [ 1, 0, 2, 0, 0, 0, 0, 0, 0, 2, 0, 1 ],
    [ 1, 0, 0, 0, 0, 0, 0, 0, 0, 0, 0, 1 ],
    [ 1, 0, 2, 0, 0, 3, 3, 0, 0, 2, 0, 1 ],
    [ 1, 0, 2, 0, 0, 3, 3, 0, 0, 2, 0, 1 ],
    [ 1, 0, 0, 0, 0, 0, 0, 0, 0, 0, 0, 1 ],
    [ 1, 0, 2, 0, 0, 0, 0, 0, 0, 2, 0, 1 ],
    [ 1, 0, 2, 2, 0, 2, 2, 0, 2, 2, 0, 1 ],
    [ 1, 0, 0, 0, 0, 0, 0, 0, 0, 0, 0, 1 ],
    [ 1, 3, 1, 1, 1, 1, 1, 1, 1, 1, 1, 1 ]
  ],
  "MapFloor": [
    [ 1, 1, 1, 1, 1, 1, 1, 1, 1, 1, 1, 1 ],
    [ 1, 1, 1, 3, 1, 1, 1, 1, 1, 1, 1, 1 ],
    [ 1, 1, 1, 1, 1, 1, 1, 1, 1, 1, 1, 1 ],
    [ 1, 1, 1, 1, 1, 3, 1, 1, 1, 1, 1, 1 ],
    [ 1, 1, 1, 1, 1, 1, 1, 1, 1, 1, 1, 1 ],
    [ 1, 1, 1, 1, 1, 1, 1, 1, 1, 1, 1, 1 ],
    [ 1, 1, 1, 1, 1, 1, 1, 1, 1, 1, 1, 1 ],
    [ 1, 1, 1, 3, 1, 1, 1, 1, 1, 1, 1, 1 ],
    [ 1, 1, 1, 1, 1, 1, 1, 1, 1, 1, 1, 1 ],
    [ 1, 1, 1, 1, 1, 1, 1, 1, 1, 1, 1, 1 ],
    [ 1, 1, 1, 1, 1, 1, 1, 1, 1, 1, 1, 1 ],
    [ 1, 1, 1, 1, 1, 1, 1, 1, 1, 1, 1, 1 ]
  ],
  "Sprites": [
    {
      "ID": 1,
      "Type": "Torch",
      "Cells": [
        {
          "X": 3,
          "Y": 1
        },
        {
          "X": 1,
          "Y": 2
        }
      ]
    }
  ],
  "Player": {
    "X": 10,
    "Y": 1
  },
  "Items": [
    {
      "ID": 1,
      "Type": "Heal",
      "Position": {
        "X": 1,
        "Y": 3
      }
    }
  ]
}