{
  "MapCeiling": [
    [ 2, 2, 2, 2, 2, 2, 2, 2, 2, 2 ],
    [ 2, 1, 1, 1, 1, 1, 1, 1, 1, 2 ],
    [ 2, 1, 3, 3, 3, 3, 3, 3, 1, 2 ],
    [ 2, 1, 3, 4, 4, 4, 4, 3, 1, 2 ],
    [ 2, 1, 3, 4, 5, 6, 4, 3, 1, 2 ],
    [ 2, 1, 3, 4, 7, 8, 4, 3, 1, 2 ],
    [ 2, 1, 3, 4, 4, 4, 4, 3, 1, 2 ],
    [ 2, 1, 3, 3, 3, 3, 3, 3, 1, 2 ],
    [ 2, 1, 1, 1, 1, 1, 1, 1, 1, 2 ],
    [ 2, 2, 2, 2, 2, 2, 2, 2, 2, 2 ]
  ],
  "MapWalls": [
    [ 1, 1, 1, 1, 1, 2, 2, 2, 2, 2 ],
    [ 8, 0, 0, 0, 0, 0, 0, 0, 0, 3 ],
    [ 8, 0, 0, 0, 0, 0, 0, 0, 0, 3 ],
    [ 8, 0, 0, 0, 0, 0, 0, 0, 0, 3 ],
    [ 8, 0, 0, 0, 0, 0, 0, 0, 0, 3 ],
    [ 7, 0, 0, 0, 0, 0, 0, 0, 0, 4 ],
    [ 7, 0, 0, 0, 0, 0, 0, 0, 0, 4 ],
    [ 7, 0, 0, 0, 0, 0, 0, 0, 0, 4 ],
    [ 7, 0, 0, 0, 0, 0, 0, 0, 0, 4 ],
    [ 6, 6, 6, 6, 6, 0, 5, 5, 5, 5 ]
  ],
  "MapFloor": [
    [5, 5, 5, 5, 5, 5, 5, 5, 5, 5],
    [5, 5, 5, 5, 5, 5, 5, 5, 5, 5],
    [5, 5, 5, 5, 5, 5, 5, 5, 5, 5],
    [5, 5, 5, 5, 5, 5, 5, 5, 5, 5],
    [5, 5, 5, 5, 5, 5, 5, 5, 5, 5],
    [5, 5, 5, 5, 5, 5, 5, 5, 5, 5],
    [5, 5, 5, 5, 5, 5, 5, 5, 5, 5],
    [5, 5, 5, 5, 5, 5, 5, 5, 5, 5],
    [5, 5, 5, 5, 5, 5, 5, 5, 5, 5],
    [5, 5, 5, 5, 5, 5, 5, 5, 5, 5]
  ],
  "Sprites": [
    {
      "ID": 1,
      "Type": "Torch",
      "Cells": [
        {
          "X": 3,
          "Y": 1
        },
        {
          "X": 1,
          "Y": 2
        }
      ]
    }
  ],
  "Player": {
    "X": 10,
    "Y": 1
  },
  "Items": [
    {
      "ID": 1,
      "Type": "Heal",
      "Position": {
        "X": 1,
        "Y": 3
      }
    }
  ]
}