{
  "MapCeiling": [
    [ 2, 2, 2, 2, 2, 2, 2, 2, 2, 2 ],
    [ 2, 2, 2, 2, 2, 2, 2, 2, 2, 2 ],
    [ 2, 2, 2, 2, 2, 2, 2, 2, 2, 2 ],
    [ 2, 2, 2, 2, 2, 2, 2, 2, 2, 2 ],
    [ 2, 2, 2, 2, 2, 2, 2, 2, 2, 2 ],
    [ 2, 2, 2, 2, 2, 2, 2, 2, 2, 2 ],
    [ 2, 2, 2, 2, 2, 2, 2, 2, 2, 2 ],
    [ 2, 2, 2, 2, 2, 2, 2, 0, 2, 2 ],
    [ 2, 2, 2, 2, 2, 2, 2, 2, 2, 2 ],
    [ 2, 2, 2, 2, 2, 2, 2, 2, 2, 2 ]
  ],
  "MapWalls": [
    [ 1, 1, 1, 1, 1, 2, 2, 2, 2, 2 ],
    [ 8, 0, 0, 0, 0, 0, 0, 0, 0, 3 ],
    [ 8, 0, 0, 0, 0, 0, 0, 0, 0, 3 ],
    [ 8, 0, 0, 0, 0, 0, 0, 0, 0, 3 ],
    [ 8, 0, 0, 0, 0, 0, 0, 0, 0, 3 ],
    [ 7, 0, 0, 0, 0, 0, 0, 0, 0, 4 ],
    [ 7, 0, 0, 0, 0, 0, 0, 0, 0, 4 ],
    [ 7, 0, 0, 0, 0, 0, 0, 0, 0, 4 ],
    [ 7, 0, 0, 0, 0, 0, 0, 0, 0, 4 ],
    [ 6, 6, 6, 6, 6, 0, 5, 5, 5, 5 ]
  ],
  "MapFloor": [
    [ 1, 1, 1, 1, 1, 1, 1, 1, 1, 1 ],
    [ 1, 1, 1, 1, 1, 1, 1, 1, 1, 1 ],
    [ 1, 1, 1, 1, 1, 1, 1, 1, 1, 1 ],
    [ 1, 1, 1, 1, 1, 1, 1, 1, 1, 1 ],
    [ 1, 1, 1, 1, 1, 1, 1, 1, 1, 1 ],
    [ 1, 1, 1, 1, 1, 1, 1, 1, 1, 1 ],
    [ 1, 1, 1, 1, 1, 1, 1, 1, 1, 1 ],
    [ 1, 1, 1, 1, 1, 1, 1, 1, 1, 1 ],
    [ 1, 1, 1, 1, 1, 1, 1, 1, 1, 1 ],
    [ 1, 1, 1, 1, 1, 1, 1, 1, 1, 1 ]
  ],
  "Sprites": [
    {
      "Id": 0,
      "Type": 0,
      "Position": {
        "X": 1,
        "Y": 2
      }
    },
    {
      "Id": 3,
      "Type": 2,
      "Position": {
        "X": 2,
        "Y": 2
      }
    },
    {
      "Id": 3,
      "Type": 2,
      "Position": {
        "X": 5,
        "Y": 5
      }
    }
  ]
}