{
  "MapCeiling": [
    [ 1, 1, 1, 1, 1, 1, 1, 1, 1, 1, 1, 1 ],
    [ 1, 0, 0, 0, 0, 1, 1, 0, 0, 0, 0, 1 ],
    [ 1, 0, 0, 0, 0, 0, 0, 0, 0, 0, 0, 1 ],
    [ 1, 0, 0, 0, 1, 0, 0, 0, 0, 1, 0, 1 ],
    [ 1, 0, 0, 0, 0, 0, 1, 1, 0, 0, 0, 1 ],
    [ 1, 0, 0, 0, 0, 0, 0, 0, 0, 0, 0, 1 ],
    [ 1, 0, 1, 1, 0, 1, 0, 0, 1, 1, 0, 1 ],
    [ 1, 0, 1, 0, 0, 0, 0, 0, 0, 0, 0, 1 ],
    [ 1, 0, 0, 0, 0, 0, 0, 0, 0, 0, 0, 1 ],
    [ 1, 0, 0, 0, 0, 0, 0, 0, 0, 0, 0, 1 ],
    [ 1, 0, 0, 0, 0, 0, 0, 0, 0, 0, 0, 1 ],
    [ 1, 1, 1, 1, 1, 1, 1, 1, 1, 1, 1, 1 ]
  ],
  "MapWalls": [
    [ 1, 1, 1, 1, 1, 1, 1, 1, 1, 1, 1, 1 ],
    [ 1, 0, 0, 0, 0, 1, 0, 0, 0, 0, 0, 1 ],
    [ 1, 0, 0, 2, 0, 2, 2, 0, 2, 2, 0, 1 ],
    [ 1, 0, 2, 0, 0, 0, 0, 0, 0, 2, 0, 1 ],
    [ 1, 0, 0, 0, 0, 0, 0, 0, 0, 0, 0, 1 ],
    [ 1, 0, 2, 0, 0, 3, 3, 0, 0, 2, 0, 1 ],
    [ 1, 0, 2, 0, 0, 3, 3, 0, 0, 2, 0, 1 ],
    [ 1, 0, 0, 0, 0, 0, 0, 0, 0, 0, 0, 1 ],
    [ 1, 0, 2, 0, 0, 0, 0, 0, 0, 2, 0, 1 ],
    [ 1, 0, 2, 2, 0, 2, 2, 0, 2, 2, 0, 1 ],
    [ 1, 0, 0, 0, 0, 0, 0, 0, 0, 0, 0, 1 ],
    [ 1, 3, 1, 1, 1, 1, 1, 1, 1, 1, 1, 1 ]
  ],
  "MapFloor": [
    [ 1, 1, 1, 1, 1, 1, 1, 1, 1, 1, 1, 1 ],
    [ 1, 0, 0, 0, 0, 1, 1, 0, 0, 0, 0, 1 ],
    [ 1, 0, 0, 0, 0, 0, 0, 0, 0, 0, 0, 1 ],
    [ 1, 0, 0, 0, 1, 0, 0, 0, 0, 1, 0, 1 ],
    [ 1, 0, 0, 0, 0, 0, 1, 1, 0, 0, 0, 1 ],
    [ 1, 0, 0, 0, 0, 0, 0, 0, 0, 0, 0, 1 ],
    [ 1, 0, 1, 1, 0, 1, 0, 0, 1, 1, 0, 1 ],
    [ 1, 0, 1, 0, 0, 0, 0, 0, 0, 0, 0, 1 ],
    [ 1, 0, 0, 0, 0, 0, 0, 0, 0, 0, 0, 1 ],
    [ 1, 0, 0, 0, 0, 0, 0, 0, 0, 0, 0, 1 ],
    [ 1, 0, 0, 0, 0, 0, 0, 0, 0, 0, 0, 1 ],
    [ 1, 1, 1, 1, 1, 1, 1, 1, 1, 1, 1, 1 ]
  ],
  "Sprites": [
    {
      "ID": 1,
      "Type": "Torch",
      "Cells": [
        {
          "X": 3,
          "Y": 1
        },
        {
          "X": 1,
          "Y": 2
        }
      ]
    }
  ],
  "Player": {
    "X": 10,
    "Y": 1
  },
  "Items": [
    {
      "ID": 1,
      "Type": "Heal",
      "Position": {
        "X": 1,
        "Y": 3
      }
    }
  ]
}