{
  "MapCeiling": [
    [ 2, 2, 2, 2, 2, 2, 2, 2, 2, 2 ],
    [ 2, 2, 2, 2, 2, 2, 2, 2, 2, 2 ],
    [ 2, 2, 2, 2, 2, 2, 2, 2, 2, 2 ],
    [ 2, 2, 2, 2, 2, 2, 2, 2, 2, 2 ],
    [ 2, 2, 2, 2, 2, 2, 2, 2, 2, 2 ],
    [ 2, 2, 2, 2, 2, 2, 2, 2, 2, 2 ],
    [ 2, 2, 2, 2, 2, 2, 2, 2, 2, 2 ],
    [ 2, 2, 2, 2, 2, 2, 2, 0, 2, 2 ],
    [ 2, 2, 2, 2, 2, 2, 2, 2, 2, 2 ],
    [ 2, 2, 2, 2, 2, 2, 2, 2, 2, 2 ]
  ],
  "MapWalls": [
    [ 1, 1, 1, 1, 1, 2, 2, 2, 2, 2 ],
    [ 8, 0, 0, 0, 0, 0, 0, 0, 0, 3 ],
    [ 8, 0, 0, 0, 0, 0, 0, 0, 0, 3 ],
    [ 8, 0, 0, 0, 0, 0, 0, 0, 0, 3 ],
    [ 8, 0, 0, 0, 0, 0, 0, 0, 0, 3 ],
    [ 7, 0, 0, 0, 0, 0, 0, 0, 0, 4 ],
    [ 7, 0, 0, 0, 0, 0, 0, 0, 0, 4 ],
    [ 7, 0, 0, 0, 0, 0, 0, 0, 0, 4 ],
    [ 7, 0, 0, 0, 0, 0, 0, 0, 0, 4 ],
    [ 6, 6, 6, 6, 6, 0, 5, 5, 5, 5 ]
  ],
  "MapFloor": [
    [ 1, 1, 1, 1, 1, 1, 1, 1, 1, 1 ],
    [ 1, 1, 1, 1, 1, 1, 1, 1, 1, 1 ],
    [ 1, 1, 1, 1, 1, 1, 1, 1, 1, 1 ],
    [ 1, 1, 1, 1, 1, 1, 1, 1, 1, 1 ],
    [ 1, 1, 1, 1, 1, 1, 1, 1, 1, 1 ],
    [ 1, 1, 1, 1, 1, 1, 1, 1, 1, 1 ],
    [ 1, 1, 1, 1, 1, 1, 1, 1, 1, 1 ],
    [ 1, 1, 1, 1, 1, 1, 1, 1, 1, 1 ],
    [ 1, 1, 1, 1, 1, 1, 1, 1, 1, 1 ],
    [ 1, 1, 1, 1, 1, 1, 1, 1, 1, 1 ]
  ],
  "Sprites": [
    {
      "Type": 0,
      "Id": 0,
      "Position": {
        "X": 1,
        "Y": 1
      }
    },
    {
      "Type": 0,
      "Id": 1,
      "Position": {
        "X": 2,
        "Y": 1
      }
    },
    {
      "Type": 0,
      "Id": 2,
      "Position": {
        "X": 3,
        "Y": 1
      }
    },
    {
      "Type": 0,
      "Id": 3,
      "Position": {
        "X": 4,
        "Y": 1
      }
    },
    {
      "Type": 0,
      "Id": 4,
      "Position": {
        "X": 5,
        "Y": 1
      }
    },
    {
      "Type": 0,
      "Id": 5,
      "Position": {
        "X": 6,
        "Y": 1
      }
    },
    {
      "Type": 0,
      "Id": 6,
      "Position": {
        "X": 7,
        "Y": 1
      }
    },
    {
      "Type": 1,
      "Id": 0,
      "Position": {
        "X": 8,
        "Y": 1
      }
    },
    {
      "Type": 1,
      "Id": 1,
      "Position": {
        "X": 8,
        "Y": 2
      }
    }
  ]
}